int	целое
long	лонг
char	симв
float	натур1
const	пост
return	возврат
struct	структура
union	объединение
sizeof	размерность
else	иначе
do	до
register	регистр
enum	набор
while	пока
continue	продолжить
goto	переход
for	для
switch	выбор
extern	внешн
case	при
volatile	volatile
auto	авто
short	сшорт
static	статик
if	если
break	стоп
double	веществ
default	поумолчанию
typedef	опредтип
void	пусто
signed	знаковое
unsigned	беззнак
#include	#вставить
#define	#опред
#undef	#разопред
#ifdef	#еслиопред
#ifndef	#еслинеопред
#endif	#конецесли
#error	#ошибка
